That share has been rising steadily over the years — only 11 percent of the total vote was cast before Election Day in 1996 , according to the Census Bureau -- and seems likely to jump again this year .	Den andelen har ökat stadigt med åren – bara 11 procent av de samlade rösterna lades före valdagen 1996 enligt folkbokföringsbyrån – och det verkar troligt att den kommer öka ordentligt igen .
“ We ’ve requested other nations to help us populate the zoo with different species of animals , including a pig , ” Saqib said .	” Vi har bett andra stater att hjälpa oss befolka djurparken med olika djurarter , inklusive en gris ” , sade Saqib .
Several analysts have suggested Huawei is best placed to benefit from Samsung 's setback .	Flera analytiker har föreslagit att Huawei har bäst position för att tjäna på Samsungs tillbakagång .
The 10 - week course has been " certified " by UK spy agency GCHQ .	10-veckorskursen har ” certifierats ” av brittiska spionmyndigheten GCHQ .
Throughout history , the international hair market has always had a political dimension , says Tarlo .	Genom historien har den internationella hårmarknaden alltid haft en politisk dimension , säger Tarlo .
Shenzhen 's traffic police have opted for unconventional penalties before .	Shenzhens trafikpolis har valt okonventionella straff förut .
Much of the debate , from the Democratic side this year , has been about white male identity .	Mycket av debatten , från Demokraternas sida i år , har handlat om vit manlig identitet .
Seagal , whose grandmother was from Vladivostok in Russia 's far east , has made frequent trips to Russia in recent years and visited Kamchatka and Sakhalin in September .	Seagal , vars farmor kom från Vladivostok i Rysslands östligaste delar har gjort flera resor till Ryssland de senaste åren och besökte Kamtjatka och Sakhalin i september .
Researchers have been investigating potential for male hormonal contraceptives for around 20 years .	Forskare har undersökt potentialen för manliga hormonella preventivmedel i ungefär 20 år .
Ms Pugh has received treatment at Papworth and Addenbrooke 's Hospitals in Cambridgeshire .	Ms Pugh har fått behandling vid Papworths och Addenbrookes sjukhus i Cambridgeshire .
Students like Rai have been meeting with counsellors at the school to talk about what happened , but she said the biggest comfort has come from seeing her friends .	Studenter som Rai har träffat kuratorer på skolan för att prata om det som hände , men hon säger att den största trösten har kommit från att träffa sina vänner .
Students like Rai have been meeting with counsellors at the school to talk about what happened , but she said the biggest comfort has come from seeing her friends .	Studenter som Rai har träffat kuratorer på skolan för att prata om det som hände , men hon säger att den största trösten har kommit från att träffa sina vänner .
Like many people I know , I ’ve spent recent months staying up late , reading polls in terror .	Som många jag känner har jag tillbringat de senaste månaderna med att sitta uppe sent och i skräck läsa opinionsundersökningar .
Christian Wolmar , who has written a number of books on railway history , will stand in the contest on 1 December .	Christian Wolmar som har skrivit ett antal böcker om järnvägshistoria kommer att kandidera den 1 december .
Meanwhile , the estranged wife of a government whip has launched her campaign to take the seat .	Samtidigt har den frånskilda frun till en av regeringens inpiskare lanserat sin kampanj för att ta platsen .
He ’s spoken in favour of torture .	Han har uttalat sig till stöd för tortyr .
The RSPB ’s stance has also brought it into conflict with many leading conservationists , from the author of the petition , Mark Avery , to the TV presenter Chris Packham .	RSPB:s ståndpunkt har även gjort att det kommit i konflikt med flera ledande naturvårdare , från namninsamlingens författare Mark Avery till TV-presentatören Chris Packham .
But big reductions have also been pencilled in for cod , sole , plaice , megrim and pollack in the Celtic and Irish Seas .	Men stora minskningar har redan skissats ned vad gäller torsk , sjötunga , spätta , glasvar och sej i Keltiska havet och Irländska sjön .
The Hong Kong government , which is led by pro-Beijing lawmakers , have argued that the pair should not take office .	Hong Kongs regering , som leds av Beijing-vänliga lagstiftare , har ansett att paret inte bör tillträda posten .
We are so disappointed because we have dropped six points playing at home .	Vi är så besvikna eftersom vi har tappat sex poäng när vi spelat hemma .
It has also opened VW up to huge compensation claims , legal action and has seen it take more than € 16bn of provisions .	Det har även öppnat upp VW för enorma skadeståndsanspråk , rättsliga åtgärder och har sett det ta mer än 16 md euro i avskrivningar .
It has also opened VW up to huge compensation claims , legal action and has seen it take more than € 16bn of provisions .	Det har även öppnat upp VW för enorma skadeståndsanspråk , rättsliga åtgärder och har sett det ta mer än 16 md euro i avskrivningar .
This has not stopped investors flocking to put their money in the funds .	Detta har inte hindrat investerare från att flockas för att sätta in sina pengar i fonderna .
This means that they have not benefited from the uplift that the fall in sterling has given to overseas assets .	Detta betyder att de inte har tjänat på den ökning som sterlingens fall har orsakat hos tillgångar utomlands .
Four in 10 adults have been injured due to bad weather while nine in 10 underestimate how chilly Britain can get in the winter time .	Fyra av tio vuxna har skadats på grund av dåligt väder medan nio av tio underskattar hur kyligt Storbritannien kan bli vintertid .
According to the director 's own count , to date he has made eight feature films .	Enligt regissörens egen beräkning har han till dags dato gjort åtta långfilmer .
Voting has , in the vernacular of terror , become the new soft target .	Röstning har , i terrorns jargong , blivit det nya mjuka målet .
More than 5.7 million Floridians have already hit the polls after about two weeks of in - person early voting .	Mer än 5,7 miljoner floridabor har redan gått och röstat efter cirka två veckor med personligt förtidsröstande .
The Dutch students have yet to decide if they will be commercializing their electric motorcycle .	De nederländska studenterna har ännu inte bestämt om de kommer att kommersialisera sin elektriska motorcykel .
In the Netherlands , authorities have taken a lower - tech approach to tracking drones .	I Nederländerna har myndigheterna tagit till ett lågteknologiskt angreppssätt för att spåra drönare .
There is no parade and there never has been .	Det finns ingen parad och det har aldrig funnits en .
Alejandra González Anaya , one of the parade 's creative directors , explained to CNN why Mexico have decided now is the time to put on such a show .	Alejandra González Anaya , en av paradens kreativa chefer , förklarade för CNN varför Mexiko har beslutat att det är dags nu att bjuda på en sådan show .
Although Iceland was under the political control of Denmark until a much later date ( 1918 ) , very little influence and borrowing from Danish has occurred in the Icelandic language .	Fastän Island stod under Danmarks politiska kontroll fram till ett mycket senare datum ( 1918 ) har väldigt lite inflytande och inlån från danskan skett i det isländska språket .
The Danevirke has remained in German possession ever since .	Danevirke har förblivit i tysk ägo sedan dess .
Global warming has caused a change in the pattern of the rainy seasons .	Global uppvärmning har orsakat en förändring i regnperiodernas mönster .
It contains a tiny lagoon , which has all but dried up .	Den innehåller en liten lagun som nästan har torkat ut .
Over the past 50 years , the destruction of habitat surrounding agricultural land has degraded approximately 40 % of agricultural land worldwide via erosion , salinization , compaction , nutrient depletion , pollution , and urbanization .	De senaste 50 åren har förstörelse av livmiljöer runt jordbruksmarker försämrat cirka 40 % av jordbruksarealer världen över genom erosion , försaltning , kompaktering , utarmning av näringsämnen , förorening och urbanisering .
However , in Thailand , urbanization has also resulted in massive increases in problems such as obesity .	I Thailand har dock urbaniseringen också resulterat i massiva ökningar av problem som fetma .
Unfortunately , rapid population growth and urban sprawl has covered much of these ecosystems with development .	Tyvärr har en snabb befolkningstillväxt och stadsspridning täckt mycket av dessa ekosystem med bebyggelse .
Since the 1960s , the South Korean economy has grown enormously and the economic structure was radically transformed .	Sedan 1960-talet har den sydkoreanska ekonomin vuxit enormt och den ekonomiska strukturen transformerades radikalt .
Low per capita income has been proposed as a cause for grievance , prompting armed rebellion .	Låg inkomst per capita har föreslagits som en anledning till missnöje , som leder till beväpnat uppror .
There has , however , been extensive statistical analysis of demographic and population data which includes women , especially in their childbearing roles .	Det har dock gjorts omfattande statistisk analys av demografi- och befolkningsdata som inkluderar kvinnor , särskilt i sin barnafödande roll .
Outside Japan , beginning with Emperor Shōwa , the Emperors are often referred to by their given names , both whilst alive and posthumously .	Utanför Japan , med början med kejsar Shōwa , har kejsarna ofta omtalats med sina förnamn , både medan de lever och postumt .
The radar system for which Alvarez is best known and which has played a major role in aviation , most particularly in the post war Berlin airlift , was Ground Controlled Approach ( GCA ) .	Radarsystemet som Alvarez är mest känd för och som har spelat en stor roll i luftfart , alldeles särskilt i efterkrigets luftbro till Berlin , var Ground Controlled Approach ( GCA ) .
As of August 2015 , Kesha has released little information about her upcoming third studio album .	Fram till augusti 2015 har Kesha släppt väldigt lite information om hennes kommande tredje studioalbum .
With 71 goals in 137 international matches , he has shot a record number of goals for the DFB .	Med 71 mål på 137 internationella matcher har han slagit rekord i antal mål för DFB .
The photo clearly shows the narrow touch display bar above the keyboard that has been anticipated in rumors .	Bilden visar tydligt den smala pekskärmsstrimman ovanför tangentbordet som har förutsetts i rykten .
A Swedish study has shown that animals seldom , if at all , land after the 2 month breeding period .	En svensk studie har visat att djur sällan , om alls , landar efter den 2 månader långa parningsperioden .
It is a political process and I have decided not to be present , so it was said .	Det är en politisk process och jag har beslutat att inte vara närvarande , så var det sagt .
For the time being , the deal between Aoun and Hariri has brought the two enemy factions closer together .	För tillfället har överenskommelsen mellan Aoun och Hariri fört de två fiendefaktionerna närmare tillsammans .
It is no surprise that the federal and state governments have classified the National Natural Heritage as a nation - wide endeavor of the highest priority and have documented it starting in 2005 in a coalition contract .	Det är ingen överraskning att de federala och statliga regeringarna har klassificerat det nationella naturarvet som en landsomfattande strävan av högsta prioritet och har dokumenterat dess början 2005 i ett koalitionskontrakt .
It is no surprise that the federal and state governments have classified the National Natural Heritage as a nation - wide endeavor of the highest priority and have documented it starting in 2005 in a coalition contract .	Det är ingen överraskning att de federala och statliga regeringarna har klassificerat det nationella naturarvet som en landsomfattande strävan av högsta prioritet och har dokumenterat dess början 2005 i ett koalitionskontrakt .
Unlike that of the 28th of October , Mr. Comey 's letter has hardly been commented upon .	Till skillnad från det från 28 oktober har mr Comeys brev knappt kommenterats .
The AKP 's Islamic conservatives have taken this refusal as justification for the questionings .	AKP:s islamistiska konservativa har tagit denna vägran som ett rättfärdigande för utfrågningarna .
The guide is problematic , firstly because it has been developed " in the context of a state of emergency " .	Guiden är problematisk , för det första eftersom den har tagits fram ” i ett sammanhang av undantagstillstånd ” .
It has been emphasised that we absolutely can not continue with those who are completely against Italy .	Det har betonats att vi absolut inte kan fortsätta med de som är helt emot Italien .
The CGI Mestre have stated in a note , that there will be no rise in VAT , for 2017 at least .	CGI Mestre har uppgett i en notering att det inte kommer förekomma någon höjning av moms , i alla fall inte under 2017 .
Four students at Roma Tre University have developed a motorcycle helmet that can ' read thoughts ' by helping to anticipate drivers ' actions .	Fyra studenter vid Roma Tre University har utvecklat en motorcykelhjälm som kan ” läsa tankar ” genom att hjälpa till att förutse förares handlingar .
One of the examples of research applied under safety measures has also produced a humanoid robot to compete with Valentino Rossi .	Ett av exemplen på forskning som tillämpas under säkerhetsåtgärder har också producerat en humanoid robot för att tävla med Valentino Rossi .
Amazon has become the fourth American company with the largest market capitalisation , surpassing ExxonMobil .	Amazon har blivit det fjärde amerikanska företaget med det högsta börsvärdet , överträffande ExxonMobil .
For the first time in the last six years the rate of unemployment has dropped below 20 % , and there are already 600,000 more people employed than there were a year ago .	För första gången under de senaste sex åren har arbetslöshetsgraden sjunkit under 20 % och det är redan 600 000 personer fler anställda än det var för ett år sedan .
The unions have been very combative and on several occasions have called for the repeal of the legislation that Fátima Báñez is proudest of .	Fackförbunden har varit väldigt stridslystna och vid flera tillfällen har de krävt ett upphävande av den lagstiftning som Fátima Báñez är mest stolt över .
The Minister of Defense has allowed her to remain General Secretary of the party for now .	Försvarsministern har tillåtit henne att stanna kvar som generalsekreterare för partiet för tillfället .
The consulted sources have said that it is " 100 % Cospedal " .	De rådfrågade källorna har sagt att det är ” 100 % Cospedal ” .
May has received great criticism for avoiding and not responding openly to the media after the judicial ruling on Brexit .	May har fått stor kritik för att ha undvikit och inte svarat öppet till media efter rättsutlåtandet om Brexit .
The Islamic citizens who have settled since the beginning of the 1960s emigrated primarily from Turkey .	De islamiska medborgare som har bosatt sig sedan början av 1960-talet emigrerade i huvudsak från Turkiet .
However , the friendship has fallen apart due to unofficial collaborations between the two , which has given rise to legal disputes .	Emellertid har vänskapen fallit isär på grund av inofficiella samarbeten mellan de båda , vilka gett upphov till juridiska dispyter .
